10.11
..1....o..
...o......
..oo......
..o.......
.....o.o..
o.........
..........
.o........
o.........
....o.....
